********************************
*                              *
*                              *
*                              *
*                              *
*                              *
*                              *
*                              *
*                              *
*                              *
*                              *
*                              *
*             @                *
*                              *
*                              *
*                              *
*                              *
*                              *
*                              *
*                              *
*                              *
*                              *
*                              *
*                              *
*                              *
*                              *
*                              *
********************************